3;0;0;0;1;7;0;0;0
0;0;0;0;0;3;0;0;9
0;9;0;8;0;0;0;1;2
4;0;2;0;0;0;9;6;0
0;0;0;0;8;0;0;0;3
5;0;1;0;0;0;8;2;0
0;6;0;1;0;0;0;7;5
0;0;0;0;0;9;0;0;1
2;0;0;0;3;5;0;0;0