0;0;0;0;0;7;0;0;0
0;0;3;0;6;0;0;0;0
5;6;9;0;4;8;0;0;0
0;0;0;0;5;4;1;0;6
1;0;0;0;0;6;3;9;0
0;0;0;0;0;0;0;0;0
6;9;0;0;0;0;5;8;0
3;0;7;0;0;0;4;0;0
0;2;1;0;3;0;6;0;0
